G                                                                                                                                   G
G                                                                                                                                   G
G                                                                                                                                   G
G                                                                                                                                   G
G                                                                                                                                   G
G                                                                                                                                   G
G                                                                                                                                   G
G                                                                                                                                   G
G                                                                                                                                   G
G                                                                                                                                   G
G                                                                                                                                   G
G                                                                                                                                   G
G                                                                                                                                   G
G                                                                                                                                   G
G                                                                                                                                   G
G                                                                                                                                   G
G                                                                                                                                   G
G   P P                                                                                                                             G
G                                                                       G                                                           G
G                                                                                                                                   G
G                                                                     G G G                                                         G
G                         A             A              A                           A                                                G
G G G G G G G I I I I G G G I I I I G G G G GW      G G G GW       G G G G G G G   G G G G       G G G G G       G G G G G G G G G GG
              G G G G       G G G G          G G G G       G G G G G        G G G G       G G G G         G G G G       
