G                                                                                                                                   G
G                                                                                                                                   G
G                                                                                                                                   G
G                                                                                                                                   G
G                                                                                                                                   G
G                                                                                                                                   G
G                                                                                                                                   G
G                                                                                                                                   G
G                                                                                                                                   G
G                                                                                                                                   G
G                                                                                                                                   G
G                                                                                                                                   G
G                                                                                                                                   G
G                                                                                                                                   G
G                                                                                                                                   G
G                                                                                                                                   G
G                                                                                                                                   G
G   P                                                                                                                               G
G                                                                       G                                                           G
G           N                                                                                                                       G
G                                                                     G G G                                                         G
G                      N  A             A              A                           A                                                G
G G G G G G G I I I I G G G G L L L G G G G GW      G G G GW       G G G G G G G   G G G G       G G G G G       G G G G G G G G G GG
              G G G G        G G G G         G G G G       G G G G G        G G G G       G G G G         G G G G       